04,04,04,04,04,04,04,04,04,04,04,04,04,04,04,04
04,03,03,03,03,03,03,03,03,03,03,03,03,03,03,04
04,03,03,03,03,03,03,03,03,03,03,03,03,03,03,04
04,03,03,03,03,03,04,04,04,04,03,03,03,03,03,04
04,03,03,03,03,03,03,03,03,03,03,03,03,03,03,04
04,03,03,03,03,03,03,03,03,03,03,03,03,03,03,04
04,03,03,04,04,04,04,03,03,04,04,04,04,03,03,04
04,03,03,03,03,03,03,03,03,03,03,03,03,03,03,04
04,03,03,03,03,03,03,03,03,03,03,03,03,03,03,04
04,03,03,03,03,03,04,04,04,04,03,03,03,03,03,04
04,03,03,03,03,03,03,03,03,03,03,03,03,03,03,04
04,03,03,03,03,03,03,03,03,03,03,03,03,03,03,04
04,03,03,04,04,04,04,03,03,04,04,04,04,03,03,04
04,03,03,03,03,03,03,03,03,03,03,03,03,03,03,04
04,03,03,03,03,03,03,03,03,03,03,03,03,03,03,04
04,04,04,04,04,04,04,04,04,04,04,04,04,04,04,04

1,1,1,1,1,1,1,1,1,1,1,1,1,1,1,1
1,0,0,0,0,0,0,0,0,0,0,0,0,0,0,1
1,0,0,0,0,0,0,0,0,0,0,0,0,0,0,1
1,0,0,0,0,0,1,1,1,1,0,0,0,0,0,1
1,0,0,0,0,0,0,0,0,0,0,0,0,0,0,1
1,0,0,0,0,0,0,0,0,0,0,0,0,0,0,1
1,0,0,1,1,1,1,0,0,1,1,1,1,0,0,1
1,0,0,0,0,0,0,0,0,0,0,0,0,0,0,1
1,0,0,0,0,0,0,0,0,0,0,0,0,0,0,1
1,0,0,0,0,0,1,1,1,1,0,0,0,0,0,1
1,0,0,0,0,0,0,0,0,0,0,0,0,0,0,1
1,0,0,0,0,0,0,0,0,0,0,0,0,0,0,1
1,0,0,1,1,1,1,0,0,1,1,1,1,0,0,1
1,0,0,0,0,0,0,0,0,0,0,0,0,0,0,1
1,0,0,0,0,0,0,0,0,0,0,0,0,0,0,1
1,1,1,1,1,1,1,1,1,1,1,1,1,1,1,1

