16,16

00,01,01,01,01,01,01,01,01,01,01,01,01,02,01,01
01,01,01,01,01,01,01,01,01,02,02,01,01,02,02,01
02,01,00,01,01,01,01,01,02,02,02,02,02,02,02,01
01,01,00,00,00,01,01,00,02,02,02,02,02,02,02,02
01,01,01,01,00,01,01,00,01,00,00,00,00,02,02,02
01,01,01,00,00,01,00,00,00,00,00,00,00,02,02,01
01,01,01,01,01,01,00,00,00,00,00,00,02,02,02,01
01,01,01,01,01,00,00,00,00,00,00,01,01,02,01,01
01,01,01,01,01,00,00,00,00,00,01,01,01,02,01,02
01,01,01,01,01,00,00,00,00,01,01,01,01,02,02,02
01,01,01,01,01,01,01,01,01,01,01,01,01,01,02,02
01,01,01,01,01,01,01,01,01,01,01,01,01,01,02,02
01,01,01,01,01,01,01,01,01,01,01,01,02,02,02,02
01,01,01,01,01,01,01,01,01,01,02,02,02,02,02,02
01,01,01,02,02,02,02,02,02,02,02,02,02,02,02,02
01,02,02,02,02,02,02,02,02,02,02,02,02,02,02,02

0,0,0,0,0,0,0,0,0,0,0,0,0,0,0,0
0,0,0,0,0,0,0,0,0,0,0,0,0,0,0,0
0,0,0,0,0,0,0,0,0,0,0,0,0,0,0,0
0,0,0,0,0,0,0,0,0,0,0,0,0,0,0,0
0,0,0,0,0,0,0,0,0,0,0,0,0,0,0,0
1,0,0,0,0,0,0,0,0,0,0,0,0,0,0,1
1,0,0,0,0,0,0,0,0,0,0,0,0,0,0,1
1,0,0,0,0,0,0,0,0,0,0,0,0,0,0,1
0,1,1,1,0,0,0,0,0,0,0,0,1,1,1,0
0,0,0,1,1,1,1,1,1,1,1,1,0,0,0,0
0,0,0,0,0,0,0,0,0,0,0,0,0,0,0,0
0,0,0,0,0,0,0,0,0,0,0,0,0,0,0,0
0,0,0,0,0,0,0,0,0,0,0,0,0,0,0,0
0,0,0,0,0,0,0,0,0,0,0,0,0,0,0,0
0,0,0,0,0,0,0,0,0,0,0,0,0,0,0,0
0,0,0,0,0,0,0,0,0,0,0,0,0,0,0,0


